15 12 12 12 12 12 12 12 12 12 12 12 12 12 12 16
11 10 10 18 10 10 10 10 10 18 18 18 10 10 10 11
11 10 17 17 10 17 17 10 17 10 17 10 17 17 18 11
11 18 10 10 10 10 10 18 10 18 18 10 10 10 10 11
11 10 18 17 18 17 10 17 10 17 10 17 10 10 18 11
11 18 18 18 10 18 18 10 10 10 10 18 10 18 10 11
11 10 18 18 17 18 18 10 17 10 17 10 17 10 10 11
11 10 10 10 10 18 18 10 18 18 18 18 10 10 10 11
11 10 10 17 10 17 10 17 10 17 10 17 18 18 10 11
11 10 18 18 10 17 18 18 18 18 10 10 18 10 10 11
11 18 17 10 17 10 17 18 17 18 17 10 17 18 17 11
13 12 12 12 12 12 12 12 12 12 12 12 12 12 12 14